1001111111111111
1000000000000001
1000000000000001
1000000000000001
1000000000000001
1000000000000001
1100000000000001
1000000000000001
1000000000000001
1002222222200001
1002222222200001
1111001111111111
